*********************************************************************************
*...............................................................................*
*...............................................................................*
*...*...*...*...*...*...*...*...*...*...*...*...*...*...*...*...*...*...*...*...*
*...............................................................................*
*...............................................................................*
*...*...*...*...*...*...*...*...*...*...*...*...*...*...*...*...*...*...*...*...*
*...............................................................................*
*...............................................................................*
*...*...*...*...*...*...*...*...*...*...*...*...*...*...*...*...*...*...*...*...*
*...............................................................................*
*...............................................................................*
*...*...*...*...*...*...*...*...*...*...*...*...*...*...*...*...*...*...*...*...*
*...............................................................................*
*...............................................................................*
*********************************************************************************