*********************************************************************************
*...............................................................................*
*...............................................................................*
*...*.......*.......*.......*.......*.......*.......*.......*.......*.......*...*
*...............................................................................*
*...............................................................................*
*...*.......*.......*.......*.......*.......*.......*.......*.......*.......*...*
*...............................................................................*
*...............................................................................*
*...*.......*.......*.......*.......*.......*.......*.......*.......*.......*...*
*...............................................................................*
*...............................................................................*
*...*.......*.......*.......*.......*.......*.......*.......*.......*.......*...*
*...............................................................................*
*...............................................................................*
*********************************************************************************