*********************************************************************************
*...............................................................................*
*...*.......................................................................*...*
*****...............*.......*.......*.......*.......*.......*...............*****
*...............................................................................*
*...................*********.......................*********...................*
*...........*.......*.*.*.*.*.......*********.......*.*.*.*.*.......*...........*
*...................*.*.*.*.*.......*.*...*.*.......*.*.*.*.*...................*
*...................*.*...*.*.......*.*...*.*.......*.*...*.*...................*
*...........*.......*********.......*********.......*********.......*...........*
*...............................................................................*
*...............................................................................*
*****...............*.......*.......*.......*.......*.......*...............*****
*...*.......................................................................*...*
*...............................................................................*
*********************************************************************************