********************************************************
*......................................................*
*......................................................*
*....*....*..........................*....*......*.....*
*....*....*....*....*................*....*......*.....*
*....*....*....*....*................*....*......*.....*
*....*....*....*....*......*....*....*....*......*.....*
*....*....*....*....*......*....*....*....*......*.....*
*....*....*....*....*......*....*....*....*......*.....*
*......................................................*
*....*.................................................*
*....*...................*..............*..............*
*....*...................*..............*..............*
*....*....*....*.....*...*..............*..............*
*....*....*....*.....*........*.........*..............*
*......................................................*
*......................................................*
********************************************************